10HAB
HHHHHAHHHH
HHHHHHHHHH
HHHHHHHHHH
HHAHHHHHHH
HHHHHHHHHH
HHHHHAHHHH
HHHHHHHHHH
AHHHHHHHHH
HHHHHHHHHH
HAHHHHHAHH